
 0 00000000000000000000000000000000000000000000000000000000000000000000000000000
 0 0                      0 0                                                  0
 0S0                      0 0                                                  0
 0 0                      0 0                                                  0D
 0 000000000000000000000000 0000000000000000000000000000000000000000000000000000
 0                                                                             0
 00000000000000000000000000000000000000000000000000000000000000000000000000000 0
 0 0                                                                         0 0
 0 0                                                                         0 0
 0 0                                                                         0 0
 0 0                                                                         0 0
 0 0                                                                         0 0
 0 0                                                                         0 0
 0 0                                                                         0 0
 0 0                                                                         0 0
 0 0                                                                         0 0
 0 0                                                                         0 0
 0 0                                                                         0 0
 0 0                                                                         0D0
 0 0                                                                         0 0
 0000000000000000000000000000000000000000000000000000000000000000000000000000000